461270:461272
552235:552237
194290:194293
093134:093138
810440:810441
173305:173308
654064:654069
355650:355652
336630:336633
172130:172136
539456:539458
809380:809386
896687:896689
736481:736484
536553:536554
323043:323044
740600:740605
664167:664169
801601:801603
873455:873459
075425:075426
819098:819099
042101:042105
638283:638287
084600:084606
