002204:003003
310707:311005
120968:121004
632997:633029
410805:411006
202994:203005
122589:123006
035897:036009
191989:192029
753998:754069
311508:312006
200458:201003
400885:401005
003689:004004
044818:045009
100622:101002
023705:024006
603995:604019
421797:422008
131553:132006
412808:413008
111549:112004
071878:072009
102998:103004
111896:112004
