984014:984399
687144:687399
889504:889799
696145:696399
795184:795399
991063:991199
847064:847199
758038:758299
787378:787499
876247:876399
985310:985499
699020:699699
695000:695299
829022:829199
979179:979799
859089:859499
967082:967499
877329:877499
983187:983299
678210:678399
879257:879699
957012:957399
569123:569299
959282:959599
786191:786399
